h h h h h h h
h e g g g g h
h h h g t g h
h t g g g g h
h g h h g g h
h g g g g g h
h h h h h h h